image,scanner,time,low_cve_cnt,med_cve_cnt,high_cve_cnt,crit_cve_cnt,unknown_cve_cnt,tot_cve_cnt,digest
cgr.dev/chainguard/go:latest,trivy,2022-09-14 14:39:07,0,0,0,0,0,0,sha256:efddab21710e500ee2bbffffbf7a7eae3a3e1babab531fb74c615747f3096e9b
cgr.dev/chainguard/nginx:latest,trivy,2022-09-14 14:39:30,0,0,0,0,0,0,sha256:c7c957d3663f7e074f05f841a42cd5ed9c776ebecf934c58316484003c5339ee
cgr.dev/chainguard/php:latest,trivy,2022-09-14 14:39:32,0,0,0,0,0,0,sha256:85f2f812f84bcff087f6877dedc09213f66d72e8125f19f552e428509bf7e320
golang:latest,trivy,2022-09-14 14:39:53,275,42,50,9,0,376,sha256:2d17ffd12a2cdb25d4a633ad25f8dc29608ed84f31b3b983427d825280427095
nginx:latest,trivy,2022-09-14 14:40:06,93,15,13,1,0,122,sha256:0b970013351304af46f322da1263516b188318682b2ab1091862497591189ff1
php:latest,trivy,2022-09-14 14:40:13,261,30,31,1,0,323,sha256:93e675294f2d4884625771a85e61f5c3be3622b1686516fb1de8d1e862f742d5
cgr.dev/chainguard/go:latest,trivy,2022-09-13 14:38:36,0,0,0,0,0,0,sha256:433cc4aafaffa29f7c7e497658a8db01f4902d88a8a7eaebc2ddfae20c5618bc
cgr.dev/chainguard/nginx:latest,trivy,2022-09-13 14:39:00,0,0,0,0,0,0,sha256:58765ffd6b8d01a5159b143b6a38efa6fb0a06f4f0e06659588aedd45a2c72cd
cgr.dev/chainguard/php:latest,trivy,2022-09-13 14:39:02,0,0,0,0,0,0,sha256:8dcdd2b3f8e7ee615838714a1223574ff3b1995096b488b7916eb52365e7a86e
golang:latest,trivy,2022-09-13 14:39:22,278,46,56,12,1,393,sha256:4eb9ffc8fa980d304aa8d24e00142470538be4cd459717a71495ea11467df124
nginx:latest,trivy,2022-09-13 14:39:35,93,15,13,1,0,122,sha256:2888a97f7c7d498bbcc47ede1ad0f6ced07d72dfd181071dde051863f1f79d7b
php:latest,trivy,2022-09-13 14:39:41,261,29,31,1,1,323,sha256:03af30cced0c5662ada5891d3c08823603c621598b70c1c8bda7b820dcdbc63f
cgr.dev/chainguard/go:latest,trivy,2022-09-12 14:38:52,0,0,0,0,0,0,sha256:bde801f89091c0e915b0cb35aa72410e321b3a6f99142496d5ea91e0ebd59ce4
cgr.dev/chainguard/nginx:latest,trivy,2022-09-12 14:39:19,0,0,0,0,0,0,sha256:d08d864569e20105bed1d4f58b852ea3d810e7d26ec0280011dcae1135421f3f
cgr.dev/chainguard/php:latest,trivy,2022-09-12 14:39:22,0,0,0,0,0,0,sha256:c8b5c9856ad65c07298119d56b17e3642758ddc04e399263ebe71d9fa5831620
golang:latest,trivy,2022-09-12 14:39:48,278,46,56,12,1,393,sha256:4c8f4b8402a868dc6fb3902c97032b971d0179fbe007be408b455697e98d194a
nginx:latest,trivy,2022-09-12 14:40:04,95,15,16,4,0,130,sha256:b95a99feebf7797479e0c5eb5ec0bdfa5d9f504bc94da550c2f58e839ea6914f
php:latest,trivy,2022-09-12 14:40:13,263,34,37,3,1,338,sha256:3662ba7ae93eb3765a30da35df039027b61ba5f6fb6e984e50c766d850339ebd
cgr.dev/chainguard/go:latest,trivy,2022-09-11 14:34:58,0,0,0,0,0,0,sha256:6f1111e4ed2a9ba4bd0850accd05b48c23ca11a9de0702228b8e4a621fa356f8
cgr.dev/chainguard/nginx:latest,trivy,2022-09-11 14:35:25,0,0,0,0,0,0,sha256:805d62cf1acff71c209b2c0202b45f56dab3d192d256c5dae9cec5a78ea13657
cgr.dev/chainguard/php:latest,trivy,2022-09-11 14:35:28,0,0,0,0,0,0,sha256:9308d4465235d9507e4f65e12d7cc5f2e00186ddccc8c9467ed424222ce0f9e2
golang:latest,trivy,2022-09-11 14:35:56,278,46,56,12,1,393,sha256:4c8f4b8402a868dc6fb3902c97032b971d0179fbe007be408b455697e98d194a
nginx:latest,trivy,2022-09-11 14:36:14,95,15,16,4,0,130,sha256:b95a99feebf7797479e0c5eb5ec0bdfa5d9f504bc94da550c2f58e839ea6914f
php:latest,trivy,2022-09-11 14:36:24,263,34,37,3,1,338,sha256:3662ba7ae93eb3765a30da35df039027b61ba5f6fb6e984e50c766d850339ebd
cgr.dev/chainguard/go:latest,trivy,2022-09-10 14:35:02,0,0,0,0,0,0,sha256:6ad15f732af21adaba922284b862f6d38b015526d39133f7b3f5650f6d60718d
cgr.dev/chainguard/nginx:latest,trivy,2022-09-10 14:35:28,0,0,0,0,0,0,sha256:93c325036f34fe87eb84c5dab03af2e0b0d0ed424b9858f31ee0b6c32ab52f7d
cgr.dev/chainguard/php:latest,trivy,2022-09-10 14:35:30,0,0,0,0,0,0,sha256:07d7f8260ba37620464616cd86f25c5992dbab37ff7dee14bc557af7ad65de87
golang:latest,trivy,2022-09-10 14:35:58,278,45,56,12,1,392,sha256:4c8f4b8402a868dc6fb3902c97032b971d0179fbe007be408b455697e98d194a
nginx:latest,trivy,2022-09-10 14:36:14,95,15,16,4,0,130,sha256:b95a99feebf7797479e0c5eb5ec0bdfa5d9f504bc94da550c2f58e839ea6914f
php:latest,trivy,2022-09-10 14:36:23,263,33,37,3,1,337,sha256:3662ba7ae93eb3765a30da35df039027b61ba5f6fb6e984e50c766d850339ebd
cgr.dev/chainguard/go:latest,trivy,2022-09-09 14:37:46,0,0,0,0,0,0,sha256:b7531e265fb2d5abee96cb68a276d805b52026cb26b4274b6ca3776690e62105
cgr.dev/chainguard/nginx:latest,trivy,2022-09-09 14:38:13,0,0,0,0,0,0,sha256:3da916963a1bf2ae42d03b2545382db0c2d49051495bc78544ee839f010152c2
cgr.dev/chainguard/php:latest,trivy,2022-09-09 14:38:15,0,0,0,0,0,0,sha256:741800e554b72d5c93b51664184c54bd744f8e2981219f80ffd91dbef0c01d00
golang:latest,trivy,2022-09-09 14:38:42,278,43,56,12,0,389,sha256:4c8f4b8402a868dc6fb3902c97032b971d0179fbe007be408b455697e98d194a
nginx:latest,trivy,2022-09-09 14:38:59,95,15,16,4,0,130,sha256:b95a99feebf7797479e0c5eb5ec0bdfa5d9f504bc94da550c2f58e839ea6914f
php:latest,trivy,2022-09-09 14:39:09,263,31,37,3,0,334,sha256:3662ba7ae93eb3765a30da35df039027b61ba5f6fb6e984e50c766d850339ebd
cgr.dev/chainguard/go:latest,trivy,2022-09-08 14:34:22,0,0,0,0,0,0,sha256:3979b72069076e34271c89babd8d785323a247dd70800695b88aa78e5d08a124
cgr.dev/chainguard/nginx:latest,trivy,2022-09-08 14:34:49,0,0,0,0,0,0,sha256:134006c395761439481b02666441a793fed2209b5507ef7b56ab70baa041b349
cgr.dev/chainguard/php:latest,trivy,2022-09-08 14:34:52,0,0,0,0,0,0,sha256:378c532ec784ad07b916ec8c94abe6c813b4a5c96077f2e195143f777f073aca
golang:latest,trivy,2022-09-08 14:35:19,278,42,55,12,2,389,sha256:4c8f4b8402a868dc6fb3902c97032b971d0179fbe007be408b455697e98d194a
nginx:latest,trivy,2022-09-08 14:35:35,95,15,16,4,0,130,sha256:b95a99feebf7797479e0c5eb5ec0bdfa5d9f504bc94da550c2f58e839ea6914f
php:latest,trivy,2022-09-08 14:35:44,263,30,36,3,2,334,sha256:3662ba7ae93eb3765a30da35df039027b61ba5f6fb6e984e50c766d850339ebd
cgr.dev/chainguard/go:latest,trivy,2022-09-07 14:38:54,0,0,0,0,0,0,sha256:3979b72069076e34271c89babd8d785323a247dd70800695b88aa78e5d08a124
cgr.dev/chainguard/nginx:latest,trivy,2022-09-07 14:39:20,0,0,0,0,0,0,sha256:3e0ddd06f496adef00af0a63ef7bb82ae2951f9f421843b1a8d33263d83dc0eb
cgr.dev/chainguard/php:latest,trivy,2022-09-07 14:39:22,0,0,0,0,0,0,sha256:378c532ec784ad07b916ec8c94abe6c813b4a5c96077f2e195143f777f073aca
golang:latest,trivy,2022-09-07 14:39:48,278,42,53,12,4,389,sha256:4c8f4b8402a868dc6fb3902c97032b971d0179fbe007be408b455697e98d194a
nginx:latest,trivy,2022-09-07 14:40:05,95,15,16,4,0,130,sha256:b95a99feebf7797479e0c5eb5ec0bdfa5d9f504bc94da550c2f58e839ea6914f
php:latest,trivy,2022-09-07 14:40:13,263,30,34,3,4,334,sha256:3662ba7ae93eb3765a30da35df039027b61ba5f6fb6e984e50c766d850339ebd
cgr.dev/chainguard/go:latest,trivy,2022-09-06 14:36:39,0,0,0,0,0,0,sha256:3979b72069076e34271c89babd8d785323a247dd70800695b88aa78e5d08a124
cgr.dev/chainguard/nginx:latest,trivy,2022-09-06 14:37:08,0,0,0,0,0,0,sha256:e9ceec66b7d5a6173f48b6fbcd35938306d1826fab7f43dbfdd1ad513d152144
cgr.dev/chainguard/php:latest,trivy,2022-09-06 14:37:10,0,0,0,0,0,0,sha256:378c532ec784ad07b916ec8c94abe6c813b4a5c96077f2e195143f777f073aca
golang:latest,trivy,2022-09-06 14:37:40,278,42,49,12,4,385,sha256:d3f734e1f46ec36da8c1bce67cd48536138085289e24cfc8765f483c401b7d96
nginx:latest,trivy,2022-09-06 14:37:59,95,15,16,4,0,130,sha256:b95a99feebf7797479e0c5eb5ec0bdfa5d9f504bc94da550c2f58e839ea6914f
php:latest,trivy,2022-09-06 14:38:10,263,30,34,3,4,334,sha256:3662ba7ae93eb3765a30da35df039027b61ba5f6fb6e984e50c766d850339ebd
cgr.dev/chainguard/go:latest,trivy,2022-09-05 14:35:46,0,0,0,0,0,0,sha256:28da05cdeaacb45e4afd1e466810d418c27e48debf068553012ad81054856731
cgr.dev/chainguard/nginx:latest,trivy,2022-09-05 14:36:14,0,0,0,0,0,0,sha256:a85c5cc42ebdf6ac68abdb34911efea2ac61c24c8b30bd4ab6408c76ffa17490
cgr.dev/chainguard/php:latest,trivy,2022-09-05 14:36:17,0,0,0,0,0,0,sha256:991787a6d86e2621b0c4444ce74768c82a3746e8cad573619dd0c8f6b5e219ca
golang:latest,trivy,2022-09-05 14:36:45,278,42,49,12,3,384,sha256:d3f734e1f46ec36da8c1bce67cd48536138085289e24cfc8765f483c401b7d96
nginx:latest,trivy,2022-09-05 14:37:02,95,15,16,4,0,130,sha256:b95a99feebf7797479e0c5eb5ec0bdfa5d9f504bc94da550c2f58e839ea6914f
php:latest,trivy,2022-09-05 14:37:13,263,30,34,3,3,333,sha256:3662ba7ae93eb3765a30da35df039027b61ba5f6fb6e984e50c766d850339ebd
cgr.dev/chainguard/go:latest,trivy,2022-09-04 14:33:46,0,0,0,0,0,0,sha256:5f1eaa2efc05810060fecc2205d662192b31bcaf982f6d6fc7d8e6653c39d191
cgr.dev/chainguard/nginx:latest,trivy,2022-09-04 14:34:11,0,0,0,0,0,0,sha256:bf33d4208f6f2ba45d93a0fafb94cfecad9a4ce22877f2bf63b642623f5e2c02
cgr.dev/chainguard/php:latest,trivy,2022-09-04 14:34:13,0,0,0,0,0,0,sha256:4747514f8366ca3665071900164ed852a58a73594952f832296c3705ab86bb90
golang:latest,trivy,2022-09-04 14:34:39,278,42,49,12,3,384,sha256:d3f734e1f46ec36da8c1bce67cd48536138085289e24cfc8765f483c401b7d96
nginx:latest,trivy,2022-09-04 14:34:55,95,15,16,4,0,130,sha256:b95a99feebf7797479e0c5eb5ec0bdfa5d9f504bc94da550c2f58e839ea6914f
php:latest,trivy,2022-09-04 14:35:03,263,30,34,3,3,333,sha256:3662ba7ae93eb3765a30da35df039027b61ba5f6fb6e984e50c766d850339ebd
cgr.dev/chainguard/go:latest,trivy,2022-09-03 14:34:00,0,0,0,0,0,0,sha256:2921e86937af90b77190218e4ea6c7d915867a2cc619ab238c79a996992efae0
cgr.dev/chainguard/nginx:latest,trivy,2022-09-03 14:34:25,0,0,0,0,0,0,sha256:d3b638e45c78fd04eab2225f4c4b8ed70348994810e631de2d9e9a7ffb6c1359
cgr.dev/chainguard/php:latest,trivy,2022-09-03 14:34:27,0,0,0,0,0,0,sha256:529ce693c192d4a9025de2cdafa825dc8b1620037d88688a1ccbba5749cd11e2
golang:latest,trivy,2022-09-03 14:34:56,278,42,49,12,3,384,sha256:d3f734e1f46ec36da8c1bce67cd48536138085289e24cfc8765f483c401b7d96
nginx:latest,trivy,2022-09-03 14:35:11,95,15,16,4,0,130,sha256:b95a99feebf7797479e0c5eb5ec0bdfa5d9f504bc94da550c2f58e839ea6914f
php:latest,trivy,2022-09-03 14:35:20,263,30,34,3,3,333,sha256:3662ba7ae93eb3765a30da35df039027b61ba5f6fb6e984e50c766d850339ebd
cgr.dev/chainguard/go:latest,trivy,2022-09-02 15:03:54,0,0,0,0,0,0,sha256:3f1a973c8d1cf9112449d666636ec3320464d4c7d25dff11f813455015155061
cgr.dev/chainguard/nginx:latest,trivy,2022-09-02 15:04:18,0,0,0,0,0,0,sha256:04256d279b49a22707a26fca15cfb7e9188c465e6e168d26a5ba09caf15153e8
cgr.dev/chainguard/php:latest,trivy,2022-09-02 15:04:20,0,0,0,0,0,0,sha256:368a178e7fc563e4fe9cb1dfd2c8364c1554581eabf0f65e9b9f93fcbbe727f3
golang:latest,trivy,2022-09-02 15:04:45,260,43,48,12,2,365,sha256:d3f734e1f46ec36da8c1bce67cd48536138085289e24cfc8765f483c401b7d96
nginx:latest,trivy,2022-09-02 15:05:00,95,15,16,4,0,130,sha256:b95a99feebf7797479e0c5eb5ec0bdfa5d9f504bc94da550c2f58e839ea6914f
php:latest,trivy,2022-09-02 15:05:07,245,31,33,3,2,314,sha256:3662ba7ae93eb3765a30da35df039027b61ba5f6fb6e984e50c766d850339ebd
cgr.dev/chainguard/go:latest,trivy,2022-09-01 14:34:44,0,0,0,0,0,0,sha256:a4fbd2a3cc7f8db19187c9ae3f71da77d402dee7c7ecef8d5fc4e31ddf1afb4f
cgr.dev/chainguard/nginx:latest,trivy,2022-09-01 14:35:08,0,0,0,0,0,0,sha256:1b9af15aa9c70f768235ed774fb2b70973dbe0b65c85501e404ed372bcb665cc
cgr.dev/chainguard/php:latest,trivy,2022-09-01 14:35:11,0,0,0,0,0,0,sha256:4c90a01422cb95fc9f7fb1ad0406be51e960457542c425d2a6d3a30710489750
golang:latest,trivy,2022-09-01 14:35:38,260,44,47,12,0,363,sha256:d3f734e1f46ec36da8c1bce67cd48536138085289e24cfc8765f483c401b7d96
nginx:latest,trivy,2022-09-01 14:35:53,92,17,17,4,0,130,sha256:b95a99feebf7797479e0c5eb5ec0bdfa5d9f504bc94da550c2f58e839ea6914f
php:latest,trivy,2022-09-01 14:36:01,245,32,32,4,0,313,sha256:dacfe5971d996c3ddb26374728a7789fabc7c871a87177b2944c3eec5174dfdf
cgr.dev/chainguard/go:latest,trivy,2022-08-31 14:34:50,0,0,0,0,0,0,sha256:bbdbac4deedd2a1be57a75366f29bd5a9aad27d0b2f39c23e10144ee1d37cacb
cgr.dev/chainguard/nginx:latest,trivy,2022-08-31 14:35:15,0,0,0,0,0,0,sha256:8f2932b391276207d51b574c19b12f085493f2ea6125f02d2e3b93226d8c699b
cgr.dev/chainguard/php:latest,trivy,2022-08-31 14:35:18,0,0,0,0,0,0,sha256:5d10ee8a00a8d75eecdab9548dfe4bf796be889525260ea5e01d6e2c89be1058
golang:latest,trivy,2022-08-31 14:35:41,257,42,47,12,1,359,sha256:d3f734e1f46ec36da8c1bce67cd48536138085289e24cfc8765f483c401b7d96
nginx:latest,trivy,2022-08-31 14:35:55,90,15,16,4,0,125,sha256:b95a99feebf7797479e0c5eb5ec0bdfa5d9f504bc94da550c2f58e839ea6914f
php:latest,trivy,2022-08-31 14:36:01,243,30,32,4,1,310,sha256:dacfe5971d996c3ddb26374728a7789fabc7c871a87177b2944c3eec5174dfdf
cgr.dev/chainguard/go:latest,trivy,2022-08-30 14:35:02,0,0,0,0,0,0,sha256:12ba848749d1367790738db8e7be4e28687faa34b167a6b1cfe253855502fba3
cgr.dev/chainguard/nginx:latest,trivy,2022-08-30 14:35:23,0,0,0,0,0,0,sha256:ad547586beca8f5d614a75025f2b6746b21bb02959116e67df848da577cb76d4
cgr.dev/chainguard/php:latest,trivy,2022-08-30 14:35:25,0,0,0,0,0,0,sha256:875ce2f36a7a7e1cb2d5ba580f3b810916006e0340fcaf9b0c8747faae17b802
golang:latest,trivy,2022-08-30 14:35:46,257,41,47,12,0,357,sha256:d3f734e1f46ec36da8c1bce67cd48536138085289e24cfc8765f483c401b7d96
nginx:latest,trivy,2022-08-30 14:35:59,89,15,16,4,1,125,sha256:b95a99feebf7797479e0c5eb5ec0bdfa5d9f504bc94da550c2f58e839ea6914f
php:latest,trivy,2022-08-30 14:36:05,243,29,32,4,0,308,sha256:dacfe5971d996c3ddb26374728a7789fabc7c871a87177b2944c3eec5174dfdf
cgr.dev/chainguard/go:latest,trivy,2022-08-29 14:35:11,0,0,0,0,0,0,sha256:5f37025478e7c8e2743ff134bece15d348f09c50cc4654ff3af3b94c16a65f69
cgr.dev/chainguard/nginx:latest,trivy,2022-08-29 14:35:39,0,0,0,0,0,0,sha256:7da679666b346a85417c879db63a20f2a5be9beea2a48034498505b445b9deb5
cgr.dev/chainguard/php:latest,trivy,2022-08-29 14:35:42,0,0,0,0,0,0,sha256:7b88b03fa121294c2b4745a6b806988efca1cfe688a9551399036ed893124632
golang:latest,trivy,2022-08-29 14:36:11,257,43,45,12,0,357,sha256:d3f734e1f46ec36da8c1bce67cd48536138085289e24cfc8765f483c401b7d96
nginx:latest,trivy,2022-08-29 14:36:30,89,15,16,4,0,124,sha256:b95a99feebf7797479e0c5eb5ec0bdfa5d9f504bc94da550c2f58e839ea6914f
php:latest,trivy,2022-08-29 14:36:41,243,31,30,4,0,308,sha256:dacfe5971d996c3ddb26374728a7789fabc7c871a87177b2944c3eec5174dfdf
cgr.dev/chainguard/go:latest,trivy,2022-08-28 14:33:37,0,0,0,0,0,0,sha256:e1376d9e71e4f88320a8d7821afb11c7b3a9808fe9e49d10c4e211d746edce6c
cgr.dev/chainguard/nginx:latest,trivy,2022-08-28 14:33:57,0,0,0,0,0,0,sha256:f6d05a005458866e0a7b94186a35b65cfef2924ee78fbdc8ee5ced35e89edb02
cgr.dev/chainguard/php:latest,trivy,2022-08-28 14:34:00,0,0,0,0,0,0,sha256:714c12ad08115cf6eb6ab92d68d490cf6f7a9495de0424e8fc254fdcfe8e167e
golang:latest,trivy,2022-08-28 14:34:24,257,43,45,12,0,357,sha256:d3f734e1f46ec36da8c1bce67cd48536138085289e24cfc8765f483c401b7d96
nginx:latest,trivy,2022-08-28 14:34:38,89,15,16,4,0,124,sha256:b95a99feebf7797479e0c5eb5ec0bdfa5d9f504bc94da550c2f58e839ea6914f
php:latest,trivy,2022-08-28 14:34:44,243,31,30,4,0,308,sha256:dacfe5971d996c3ddb26374728a7789fabc7c871a87177b2944c3eec5174dfdf
cgr.dev/chainguard/go:latest,trivy,2022-08-27 14:33:27,0,0,0,0,0,0,sha256:d6dd9af65ea9093e305844b0c447e70135cd63f9f713ae4e0833d4a399639db4
cgr.dev/chainguard/nginx:latest,trivy,2022-08-27 14:33:48,0,0,0,0,0,0,sha256:43ac3cc6f530427ea3a750e1554538742a9fe57a924b854b8fbcff11de97527f
cgr.dev/chainguard/php:latest,trivy,2022-08-27 14:33:49,0,0,0,0,0,0,sha256:75cf4e26f012d12252f081aa9857632f6e5f01177a5adc40b86727acaa9ecb43
golang:latest,trivy,2022-08-27 14:34:14,257,43,45,12,0,357,sha256:d3f734e1f46ec36da8c1bce67cd48536138085289e24cfc8765f483c401b7d96
nginx:latest,trivy,2022-08-27 14:34:27,89,15,16,4,0,124,sha256:b95a99feebf7797479e0c5eb5ec0bdfa5d9f504bc94da550c2f58e839ea6914f
php:latest,trivy,2022-08-27 14:34:33,243,31,30,4,0,308,sha256:dacfe5971d996c3ddb26374728a7789fabc7c871a87177b2944c3eec5174dfdf
cgr.dev/chainguard/go:latest,trivy,2022-08-26 14:34:32,0,0,0,0,0,0,sha256:f1d936354ff9997f4634bf9c6bcb88ac80d0b7819bc67fb9d1759d939182dcf5
cgr.dev/chainguard/nginx:latest,trivy,2022-08-26 14:35:00,0,0,0,0,0,0,sha256:4e6846c0670934869612cf282499d51fbcea96635df49fea60f6ecc235392139
cgr.dev/chainguard/php:latest,trivy,2022-08-26 14:35:02,0,0,0,0,0,0,sha256:00cf0f35eb46d09c76c509190e2ce49613df6093b13d2a5928316d6a5d41698d
golang:latest,trivy,2022-08-26 14:35:32,251,40,47,12,0,350,sha256:d3f734e1f46ec36da8c1bce67cd48536138085289e24cfc8765f483c401b7d96
nginx:latest,trivy,2022-08-26 14:35:50,89,13,18,4,0,124,sha256:b95a99feebf7797479e0c5eb5ec0bdfa5d9f504bc94da550c2f58e839ea6914f
php:latest,trivy,2022-08-26 14:36:00,237,28,32,4,0,301,sha256:dacfe5971d996c3ddb26374728a7789fabc7c871a87177b2944c3eec5174dfdf
cgr.dev/chainguard/go:latest,trivy,2022-08-25 14:34:09,0,0,0,0,0,0,sha256:b115a9b3c14c3ea6c960803649d067dcf8e42c5213d1fcde98b7f7a78e5d56f5
cgr.dev/chainguard/nginx:latest,trivy,2022-08-25 14:34:29,0,0,0,0,0,0,sha256:e9f0d3aaa38b5f838c02c986be4588adacc4511cc30eed4368d1217d1c7b04df
cgr.dev/chainguard/php:latest,trivy,2022-08-25 14:34:31,0,0,0,0,0,0,sha256:09fb5bccb738b7fdb9ff5bcfc2bc39aa513d386c0d7c850b69a2c680424cfbb3
golang:latest,trivy,2022-08-25 14:34:55,251,39,46,12,2,350,sha256:d3f734e1f46ec36da8c1bce67cd48536138085289e24cfc8765f483c401b7d96
nginx:latest,trivy,2022-08-25 14:35:07,89,13,18,4,0,124,sha256:b95a99feebf7797479e0c5eb5ec0bdfa5d9f504bc94da550c2f58e839ea6914f
php:latest,trivy,2022-08-25 14:35:13,237,27,31,4,2,301,sha256:dacfe5971d996c3ddb26374728a7789fabc7c871a87177b2944c3eec5174dfdf
cgr.dev/chainguard/go:latest,trivy,2022-08-24 14:34:22,0,0,0,0,0,0,sha256:f981b0fccc6eeb598660065cee57f22836e3e8a4cc2cc2024280a74e906432a7
cgr.dev/chainguard/nginx:latest,trivy,2022-08-24 14:34:44,0,0,0,0,0,0,sha256:d02b5f17cae1d3937660976a95ae715ffe2b22b4ee1d0e0b46b068ecf06b8f6e
cgr.dev/chainguard/php:latest,trivy,2022-08-24 14:34:46,0,0,0,0,0,0,sha256:a8539831e66bcfca809a19064437c9f4568800162232a6355941cdd717234f43
golang:latest,trivy,2022-08-24 14:35:08,251,39,46,12,0,348,sha256:5bbf6bd42f985a710d9a918f4ddf71825fcbf651ea5ac5a54474c79650933a2d
nginx:latest,trivy,2022-08-24 14:35:22,89,13,18,4,0,124,sha256:b95a99feebf7797479e0c5eb5ec0bdfa5d9f504bc94da550c2f58e839ea6914f
php:latest,trivy,2022-08-24 14:35:28,237,27,31,4,0,299,sha256:dacfe5971d996c3ddb26374728a7789fabc7c871a87177b2944c3eec5174dfdf
cgr.dev/chainguard/go:latest,trivy,2022-08-23 14:34:13,0,0,0,0,0,0,sha256:762780fd21c00f1a1f7c40403f509776c2b6b4a78cdf10c5bcfb70cd13ec7dc0
cgr.dev/chainguard/nginx:latest,trivy,2022-08-23 14:34:36,0,0,0,0,0,0,sha256:3cb67a2d459e342a23e8c8fec2927aaae41bc3ffe18400e74bbd0a3f4523a28e
cgr.dev/chainguard/php:latest,trivy,2022-08-23 14:34:38,0,0,0,0,0,0,sha256:96b32b14a28d8c6ca83a58c3ad534cd638130b8b05e83b1652af49ffd44c61c7
golang:latest,trivy,2022-08-23 14:35:00,255,59,64,16,0,394,sha256:1860373709cc04bacfcf3bb1aaa8c14bb1243e971e9c4e70607ffa05f72466d6
nginx:latest,trivy,2022-08-23 14:35:14,89,13,18,4,0,124,sha256:f12751f46fdb727e3ef86b1cc34a81dc776572135cf794490763842fd97128ec
php:latest,trivy,2022-08-23 14:35:20,237,35,39,4,0,315,sha256:11dc0bc4a60dcb9e8ddf1afeb1ed15fd6c9bdbd4eb619394108ed586a7994af3
cgr.dev/chainguard/go:latest,trivy,2022-08-22 14:33:52,0,0,0,0,0,0,sha256:261d5c0b7222ffa7334e2b3320c9bab209effed521d48752825b31671e47c350
cgr.dev/chainguard/nginx:latest,trivy,2022-08-22 14:34:17,0,0,0,0,0,0,sha256:b40e26cbb47c85cb0e1348cae352a2c578ffc1e6056fbe7dad440db379fb15e7
cgr.dev/chainguard/php:latest,trivy,2022-08-22 14:34:20,0,0,0,0,0,0,sha256:180ab27e7de4ca375be1eb5c3ba95f77be3fc3c2680cc7199e2a911f35c7b098
golang:latest,trivy,2022-08-22 14:34:44,255,59,64,16,0,394,sha256:1860373709cc04bacfcf3bb1aaa8c14bb1243e971e9c4e70607ffa05f72466d6
nginx:latest,trivy,2022-08-22 14:34:59,89,13,21,4,0,127,sha256:790711e34858c9b0741edffef6ed3d8199d8faa33f2870dea5db70f16384df79
php:latest,trivy,2022-08-22 14:35:07,237,35,39,4,0,315,sha256:ebd3bdb934e7bbd8343cb5a15ebab85fe299215d29d658a6dcf4ac8705c300cc
cgr.dev/chainguard/go:latest,trivy,2022-08-21 14:33:18,0,0,0,0,0,0,sha256:51876372d31e37849eda78c9931062b64d794c20399b2a0c790886d3a1461817
cgr.dev/chainguard/nginx:latest,trivy,2022-08-21 14:33:41,0,0,0,0,0,0,sha256:3414c79ceba30f733ea1f8fe3c1c807558c521394b2d21c75a7082db023984ab
cgr.dev/chainguard/php:latest,trivy,2022-08-21 14:33:43,0,0,0,0,0,0,sha256:74eb3085f655f4872dd3d6d1455cb6c9fb1dabc207899ddc8d625ec5bcaeac81
golang:latest,trivy,2022-08-21 14:34:05,255,59,64,16,0,394,sha256:1860373709cc04bacfcf3bb1aaa8c14bb1243e971e9c4e70607ffa05f72466d6
nginx:latest,trivy,2022-08-21 14:34:18,89,13,21,4,0,127,sha256:790711e34858c9b0741edffef6ed3d8199d8faa33f2870dea5db70f16384df79
php:latest,trivy,2022-08-21 14:34:24,237,35,39,4,0,315,sha256:ebd3bdb934e7bbd8343cb5a15ebab85fe299215d29d658a6dcf4ac8705c300cc
cgr.dev/chainguard/go:latest,trivy,2022-08-20 14:33:25,0,0,0,0,0,0,sha256:b40826ce1b3bded73f01be0406daf87f4a7b276c72ccf3b7eb5ef07415900545
cgr.dev/chainguard/nginx:latest,trivy,2022-08-20 14:33:50,0,0,0,0,0,0,sha256:636f8f1e4012a307451c7c1673f47a5d180ffc2a788e224c2cfc3b49d2d762d8
cgr.dev/chainguard/php:latest,trivy,2022-08-20 14:33:52,0,0,0,0,0,0,sha256:6d31c5cfa4f1c1827d901039c38e020db2bd48af2d32c14ba46ebcfd48ac92ad
golang:latest,trivy,2022-08-20 14:34:15,255,59,64,16,0,394,sha256:1860373709cc04bacfcf3bb1aaa8c14bb1243e971e9c4e70607ffa05f72466d6
nginx:latest,trivy,2022-08-20 14:34:31,89,13,21,4,0,127,sha256:790711e34858c9b0741edffef6ed3d8199d8faa33f2870dea5db70f16384df79
php:latest,trivy,2022-08-20 14:34:40,237,35,39,4,0,315,sha256:ebd3bdb934e7bbd8343cb5a15ebab85fe299215d29d658a6dcf4ac8705c300cc
cgr.dev/chainguard/go:latest,trivy,2022-08-19 14:35:21,0,0,0,0,0,0,sha256:42b2af1f1efba2a1b1ca53b7cd3db8fbb957d7609fcbf81406fdf59c1aa8853d
cgr.dev/chainguard/nginx:latest,trivy,2022-08-19 14:35:43,0,0,0,0,0,0,sha256:70932f8e4f962129135a4b37585aa296769e72ba637d349a54cd90537900281d
cgr.dev/chainguard/php:latest,trivy,2022-08-19 14:35:46,0,0,0,0,0,0,sha256:22bac7b4db2b9f3c56f12eac0d5b831670eda9a9d8dd8846f62aa8feff9bc43c
golang:latest,trivy,2022-08-19 14:36:07,255,59,64,16,0,394,sha256:1860373709cc04bacfcf3bb1aaa8c14bb1243e971e9c4e70607ffa05f72466d6
nginx:latest,trivy,2022-08-19 14:36:22,89,13,21,4,0,127,sha256:790711e34858c9b0741edffef6ed3d8199d8faa33f2870dea5db70f16384df79
php:latest,trivy,2022-08-19 14:36:30,237,35,39,4,0,315,sha256:ebd3bdb934e7bbd8343cb5a15ebab85fe299215d29d658a6dcf4ac8705c300cc
cgr.dev/chainguard/go:latest,trivy,2022-08-19 14:35:21,0,0,0,0,0,0,sha256:42b2af1f1efba2a1b1ca53b7cd3db8fbb957d7609fcbf81406fdf59c1aa8853d
cgr.dev/chainguard/nginx:latest,trivy,2022-08-19 14:35:43,0,0,0,0,0,0,sha256:70932f8e4f962129135a4b37585aa296769e72ba637d349a54cd90537900281d
cgr.dev/chainguard/php:latest,trivy,2022-08-19 14:35:46,0,0,0,0,0,0,sha256:22bac7b4db2b9f3c56f12eac0d5b831670eda9a9d8dd8846f62aa8feff9bc43c
golang:latest,trivy,2022-08-19 14:36:07,255,59,64,16,0,394,sha256:1860373709cc04bacfcf3bb1aaa8c14bb1243e971e9c4e70607ffa05f72466d6
nginx:latest,trivy,2022-08-19 14:36:22,89,13,21,4,0,127,sha256:790711e34858c9b0741edffef6ed3d8199d8faa33f2870dea5db70f16384df79
php:latest,trivy,2022-08-19 14:36:30,237,35,39,4,0,315,sha256:ebd3bdb934e7bbd8343cb5a15ebab85fe299215d29d658a6dcf4ac8705c300cc
cgr.dev/chainguard/go:latest,trivy,2022-08-17 14:37:49,0,0,0,0,0,0,sha256:5b048a77ed27725e65d9990364014cc0572f617ce2c88476ee9d110672b061f2
cgr.dev/chainguard/nginx:latest,trivy,2022-08-17 14:38:14,0,0,0,0,0,0,sha256:6fd69034aaaa38f1668958f3e2af79732c0e97808cc70db1eaf3788dc8422ed3
cgr.dev/chainguard/php:latest,trivy,2022-08-17 14:38:16,0,0,0,0,0,0,sha256:331a3a7bb159e9668ee6c993ff59a71ce0aacfa49b97b182f5fc67fb24e6f507
golang:latest,trivy,2022-08-17 14:38:36,255,60,64,16,0,395,sha256:1860373709cc04bacfcf3bb1aaa8c14bb1243e971e9c4e70607ffa05f72466d6
nginx:latest,trivy,2022-08-17 14:38:52,89,13,18,4,0,124,sha256:790711e34858c9b0741edffef6ed3d8199d8faa33f2870dea5db70f16384df79
php:latest,trivy,2022-08-17 14:38:58,237,36,39,4,0,316,sha256:ebd3bdb934e7bbd8343cb5a15ebab85fe299215d29d658a6dcf4ac8705c300cc
cgr.dev/chainguard/go:latest,trivy,2022-08-16 14:34:42,0,0,0,0,0,0,sha256:cbe9e0cc46faf4a652856f83ed911c58c27b62fe125f545a3e347960f6543974
cgr.dev/chainguard/nginx:latest,trivy,2022-08-16 14:35:06,0,0,0,0,0,0,sha256:69cbee1dc3bddd1d2dd6e44dd8294f065d1c1cc3a75f7a8c70fbbaf1d827452e
cgr.dev/chainguard/php:latest,trivy,2022-08-16 14:35:09,0,0,0,0,0,0,sha256:780977e19997fc7477c183dc7241b8c4ec7d7e99e589876ad0ee212a6edfefb8
golang:latest,trivy,2022-08-16 14:35:30,255,60,64,16,0,395,sha256:1860373709cc04bacfcf3bb1aaa8c14bb1243e971e9c4e70607ffa05f72466d6
nginx:latest,trivy,2022-08-16 14:35:48,89,13,18,4,0,124,sha256:790711e34858c9b0741edffef6ed3d8199d8faa33f2870dea5db70f16384df79
php:latest,trivy,2022-08-16 14:35:57,237,36,39,4,0,316,sha256:ebd3bdb934e7bbd8343cb5a15ebab85fe299215d29d658a6dcf4ac8705c300cc
